R 1920 1080
NO ./textures/longLiveAsap.xpm
SO ./textures/kenny.xpm
WE ./textures/offWhite.xpm
EA ./textures/vlone.xpm
S ./textures/05_hanged_man.xpm
F 4,201,162
C 197,201,199

11111111111111111111111111111111
10000000000000000000000000000001
10222222222222222222222222222201
10222222222222222222222222222201
10222222222222222222222222222201
10222222222222222222222222222201
10222222222222222222222222222201
10222222222222222222222222222201
10222222222222222222222222222201
10000000000000000000000000000001
11111111111100000111111111111111
11111111111100000111111111111111
11111111111100000111111111111111
11111111111100000111111111111111
11111111111100N00111111111111111
11111111111111111111111111111111
