R 1920 1080
NO ./path_to_the_north_texture
SO ./path_to_the_south_texture
WE ./path_to_the_west_texture
S ./path_to_the_sprite_texture
F 220,100,0
C 225,30,0
EA ./path_to_the_east_texture

    11111111            11111111111111111111111111
    10000001            10000000000000000000000001
    10000001            10000000000000000000000001
    10000001            10000001111111111111111111
    10000001            10000001
    10000001            10000001
    10000001            10000001
    10000001            10000001
    10000001111111111111100000011111111111111111111
    100N0000000000000000000000000000000000000000001
    10000000000000000000000000000000000000000000001
    11111111111111111111100000011111111111110000001
                        10000001           10000001
                        10000001           10000001
    1111111111111111111110000001           10000001
    1000000000000000000000000001           10000001
    1000000000000000000000000001           10000001
    1111111111111111111111111111           11111111
