R 10000 1201030123
NO ./textures/longLiveAsap.xpm
SO ./textures/kenny.xpm
WE ./textures/offWhite.xpm
EA ./textures/vlone.xpm
S ./textures/putin.xpm
F 4,201,162
C 197,201,199

         1111111111111111111111111
         1000000000110000000020001
         1011000001110000000202001
         1001000000000020000020S01
 111111111011000001110000000000001
 100000000011000001110110111111111
 11110111111111011100000010001
 11110111111111011101010010001
 11000000110101011100000010001
 10000000000000001100000010001
 10000000000000001101010010001
 1100000111010101111101111000111
 11110111 1110101 101111010001
 11111111 1111111 111111111111
