R 1920 1080
NO ./textures/longLiveAsap.xpm
SO ./textures/kenny.xpm
WE ./textures/offWhite.xpm
EA ./textures/vlone.xpm
S ./textures/vlone.xpm
F 4,201,162
C 197,201,199

         1111111111111111111111111
         1200000000110000000000021
         1011000001110000000000001
         10010000000000000N0000001
 111111111011000001112000000000001
 100000000011000001110110111111111
 11110111111111011100000010001
 11110111111111011101010010001
 11000000110101011100000010001
 10000000000000001100000010001
 10000000000000001101010010001
 1100000111010101111101111000111
 11110111 1110101 101111010001
 11111111 1111111 111111111111
