
R 1920 1080

NO ./textures/doom/marbface.xpm
SO ./textures/doom/mountains.xpm
WE ./textures/doom/metal.xpm
EA ./textures/doom/brick.xpm

S ./textures/doom/skeleton.xpm

F 33,4,6
C 208,233,249

1111111111111111111111111111111
1020202020202010100000000211001
10E0000000000000000020020000101
1000000000000011110000000211001
1111110111011011211111111111111
1000010101010000100000000000001
1000010111010000100000011100001
1000100000010000100000000210001
1000101111110000000000011100001
1000000000000000000000000000001
1002000020111101111111111111111
1000000000100000000000211100001
1002000020100000000002100000001
1000000000111100000021000021001
1002000020000000000000002001001
1000222000111100000021000021001
1000000000100000000002100000001
1000000000100000000000211100001
1111111111111111111111111111111
