
R 800 600

NO ./textures/kenny.xpm
SO ./textures/kenny.xpm
WE ./textures/offWhite.xpm
EA ./textures/vlone.xpm

S ./textures/05_hanged_man.xpm

F 4,201,162
C 197,201,199

1111111111111111111111111111111
1022222222201000001022222222201
1000000000000000000000000000001
1002000000201110111020000002001
1111110111111000001111110111111
1000000000000000000000000000001
1000000000000000000000000000001
1000000000002000002000000000001
1000000000000002000000000000001
1000011100000000000000011100001
1000100010000000000000100010001
1001002000000000000000002001001
1000100010000000000000100010001
100001110000000N000000011100001
1000000000000010100000000000001
1000000000001110111000000000001
1000002000000000000000002000001
1000000000001110111000000000001
1000000000000010100000000000001
1000000000000000000000000000001
1000000000000000000000000000001
1111111111111111111111111111111
